0,0,3,3,3,0,0,3,3,3,3,3,6
0,0,0,3,6,9,0,6,6,9,0,6,3
0,9,0,6,3,0,0,3,6,0,0,3,6
0,0,0,0,9,6,6,0,0,6,6,0,0
0,9,0,3,3,0,0,3,6,0,0,3,6
0,0,0,3,6,9,0,6,3,9,0,6,3
0,9,0,3,3,0,0,3,6,0,0,3,3
0,0,0,3,6,9,0,3,3,9,0,3,3
0,9,0,3,3,0,0,3,6,0,0,3,6
0,0,0,3,6,9,0,6,6,9,0,3,3